4 4 4 4 4 2 2 2 2
4 2 2 2 4 2 2 2 2
4 0 1 1 4 2 4 4 4
4 2 1 2 4 2 4 3 4
4 4 4 2 4 4 4 3 4
2 4 4 2 2 2 2 3 4
2 4 2 2 2 4 2 2 4
2 4 2 2 2 4 4 4 4
2 4 4 4 4 4 2 2 2
2 4 4 4 4 4 2 2 2